1
@
0,0
11,11
1,1,1,1,1,0,0,0,0,0,0
1,1,1,1,1,0,0,0,0,0,0
1,1,1,1,1,0,0,0,0,0,0
1,1,1,1,1,0,0,0,0,0,0
1,1,1,1,1,0,0,0,0,0,0
2,2,2,2,2,0,0,0,0,0,0
1,1,1,1,1,2,3,3,3,1,1
1,1,1,1,1,2,3,3,3,1,1
1,1,1,1,1,2,3,3,3,1,1
1,5,1,1,1,2,1,4,1,1,1
3,3,3,3,3,2,1,1,1,1,1
